strata,description,land size,year,land,building,total value
1,storage,8712,1974,2612000,2679000,5291000
1,residential,9705,,1566000,0,1566000
1,residential,7903,,152000,0,152000
1,residential,7412,1992,785000,427000,1212000
1,residential,6680,1992,830000,501000,1331000
1,residential,9540,1992,938000,504000,1442000
1,residential,10610,1992,973000,457000,1430000
1,residential,8459,1992,900000,483000,1383000
1,residential,5415,1992,772000,411000,1183000
1,residential,5389,1993,771000,469000,1240000
1,residential,5405,1992,772000,476000,1248000
1,residential,5097,1992,756000,404000,1160000
1,residential,5163,1992,759000,492000,1251000
1,residential,5354,1992,769000,450000,1219000
1,residential,5482,1992,776000,471000,1247000
1,residential,5824,1991,1331000,478000,1809000
1,residential,6153,1991,806000,423000,1229000
1,residential,7778,1992,874000,404000,1278000
1,residential,8027,1991,883000,458000,1341000
1,residential,8570,1992,904000,429000,1333000
1,residential,6665,1996,829000,588000,1417000
1,residential,6115,1995,804000,585000,1389000
1,residential,6269,1996,812000,586000,1398000
1,residential,6026,1995,800000,580000,1380000
1,residential,6028,1996,800000,534000,1334000
1,residential,6037,1994,801000,478000,1279000
1,residential,6505,1994,822000,800000,1622000
1,residential,6961,1992,841000,426000,1267000
1,residential,5946,1991,796000,423000,1219000
1,residential,5800,1991,790000,351000,1141000
1,residential,5373,1991,770000,398000,1168000
1,residential,5720,1992,787000,476000,1263000
1,residential,6219,1991,809000,388000,1197000
1,residential,7611,2019,868000,20900,888900
1,residential,7554,1992,866000,421999,1287999
1,residential,7512,1991,864000,400000,1264000
1,residential,5558,1991,779000,469000,1248000
1,residential,6561,1991,825000,717000,1542000
1,residential,5837,1991,792000,376000,1168000
1,residential,5802,1991,790000,469000,1259000
1,school,4.71acres,1971,2929000,887000,3816000
1,residential,6240,1989,819000,175000,994000
1,residential,6366,1990,825000,178000,1003000
1,residential,6037,1992,809000,248000,1057000
1,residential,6726,1988,841000,182000,1023000
1,residential,6415,1989,815000,216000,1031000
1,residential,6346,1988,824000,274000,1098000
1,residential,5926,1992,780000,206000,986000
1,residential,6001,1989,807000,192000,999000
1,residential,6087,1992,812000,263000,1075000
2,unclassified,359.8 Acres,,188495700,26480000,214975700
2,,2.15 Acres,,1837000,0,1837000
2,residential,5 Acres ,1944,1710000,51200,1761200
2,residential,21 Acres,2002,4420000,283000,4703000
2,residential,1.32 Acres ,1988,895000,22400,917400
2,residential,7873,1915,2034000,9500,2043500
2,residential,12336,2005,2939000,1942000,4881000
2,residential,9037,1967,918000,137000,1055000
2,,15014,,93100,0,93100
2,residential,18687,1935,854000,12900,866900
2,residential,16056,1972,1406000,192000,1598000
2,residential,10363,1936,1363000,470000,1833000
2,residential,14983,1967,1199000,149000,1348000
2,,15000,,291000,0,291000
2,,19184,,862000,0,862000
2,,24964,,944000,0,944000
2,,12417,,272000,0,272000
2,residential,19513,1969,1313000,78300,1391300
2,church,7017,1955,922000,40400,962400
2,residential,10363,1936,1363000,470000,1833000
2,residential,16056,,1406000,192000,1598000
2,residential,18687,,854000,12900,866900
2,residential,9037,1967,918000,137000,1055000
2,residential,9365,2005,2505000,294000,2799000
2,residential,8341,2009,2543000,890000,3433000
2,,12000,,978000,0,978000
2,,7304,,524000,0,524000
2,,7641,,532000,0,532000
2,,7466,,528000,0,528000
2,,5400,,472000,0,472000
2,residential,6679,1921,508000,13400,521400
2,,5880,,486000,0,486000
2,,5752,,482000,0,482000
2,,5594,,478000,0,478000
2,,5308,,469000,0,469000
2,residential,5481,1950,475000,12800,487800
2,residential,5895,,486000,0,486000
2,,5481,,475000,0,475000
2,residential,5481,1945,475000,11300,486300
2,residential,5609,1920,478000,12800,490800
2,,6480,,503000,0,503000
2,,7072,,517000,0,517000
2,,11542,,613000,0,613000
2,,5553,,477000,0,477000
2,,6020,,489000,0,489000
2,,5867,,437000,0,437000
2,,6132,,394000,0,394000
2,,2691,,373000,0,373000
2,,5179,,466000,0,466000
2,,352.06 Acres ,1958,8554900,5967000,91516000
3,residential,7061,1969,978000,95200,1073200
3,residential,6779,1968,965000,121000,1086000
3,residential,6779,1968,965000,140000,1105000
3,residential,6779,1968,96500,119000,215500
3,residential,7392,1968,994000,181000,1175000
3,residential,10327,1968,1115000,74000,1189000
3,residential,6815,1968,966000,121000,1087000
3,residential,6914,1968,971000,80400,1051400
3,residential,6815,1968,966000,229000,1195000
3,residential,7372,1967,993000,240000,1233000
3,residential,9090,1967,1067000,58800,1125800
3,residential,7907,1967,1017000,268000,1285000
3,residential,6925,1967,971000,141000,1112000
3,residential,7267,1967,988000,145000,1133000
3,residential,6903,1969,970000,114000,1084000
3,residential,8551,1967,1045000,123000,1168000
3,residential,9155,1967,963000,65700,1028700
3,residential,7356,1959,943000,91800,1034800
3,residential,7355,1958,962000,52300,1014300
3,residential,6378,1965,945000,119000,1064000
3,residential,12796,1965,1201000,107000,1308000
3,residential,6288,1965,940000,91300,1031300
3,residential,6300,1959,941000,31200,972200
3,residential,7668,1958,1007000,62900,1069900
3,residential,6249,1958,938000,102000,1040000
3,residential,7312,1958,960000,90400,1050400
3,residential,6256,1958,938000,98300,1036300
3,residential,8131,1958,996000,94400,1090400
3,residential,7255,1961,987000,103000,1090000
3,residential,10085,1965,1106000,266000,1372000
3,residential,9324,1965,1044000,97400,1141400
3,residential,8465,,1010000,25000,1035000
3,residential,6925,1965,942000,123000,1065000
3,residential,8992,1966,1063000,129000,1192000
3,residential,6937,1966,972000,71000,1043000
3,residential,6925,1965,0,65700,65700
3,residential,7199,1960,955000,104000,1059000
3,residential,8123,1964,1026000,85800,1111800
3,residential,8172,1960,998000,82800,1080800
3,residential,7583,1959,973000,91100,1064100
3,residential,7765,1958,1011000,59900,1070900
3,residential,7126,1959,981000,86200,1067200
3,residential,6596,1958,956000,65000,1021000
3,residential,7603,1959,1004000,138000,1142000
3,residential,8900,1958,1059000,69200,1128200
3,residential,8939,1958,955000,86600,1041600
3,residential,8057,1962,1023000,187000,1210000
3,residential,10557,1964,1011000,105000,1116000
3,residential,7419,1957,995000,186000,1181000
3,residential,6595,1958,956000,93800,1049800
4,residential,9553,1967,949000,125000,1074000
4,residential,8573,1967,868000,86800,954800
4,residential,8036,1968,926000,122000,1048000
4,residential,6098,1980,629000,178000,807000
4,residential,6262,1982,706000,197000,903000
4,residential,21903,1967,1144000,100000,1666000
4,residential,13068,1969,1999000,15800,2014800
4,residential,9243,1960,1532000,14200,1546200
4,residential,8708,1975,1443000,14100,1457100
4,townhouse,1667,1987,365500,0,365500
4,garage,17424,1965,4201000,8000,4209000
4,townhouse,1186,1968,365500,0,365500
4,townhouse,1156,1969,365500,0,365500
4,residential,7014,1959,774000,155000,929000
4,residential,9245,1959,779000,50600,829600
4,residential,8705,1994,2106000,100000,2206000
4,residential,14010,2016,868000,1071000,1939000
4,residential,7268,1961,785000,146000,931000
4,residential,7942,1961,837000,139000,976000
4,residential,5848,1979,599000,59100,658100
4,residential,11267,1958,827000,20700,847700
4,residential,8843,1958,1060000,11200,1071200
4,residential,7996,1965,887000,86200,973200
4,residential,5889,1978,832000,90100,922100
4,residential,5868,1978,832000,115000,947000
4,residential,7467,1972,932000,134000,1066000
4,residential,10211,1956,1090000,60200,1150200
4,residential,7219,1985,893000,138000,1031000
4,residential,9105,1961,868000,96800,964800
4,residential,8650,1959,1000000,237000,1237000
4,residential,8286,1961,937000,136000,1073000
4,residential,10442,1967,1046000,124000,1170000
4,residential,8697,1961,953000,62800,1015800
4,residential,12569,1957,1115000,99600,1214600
4,residential,8095,1979,958000,131000,1089000
4,residential,6726,1978,899000,224000,1123000
4,residential,14277,1967,1282000,212000,1494000
4,residential,10924,2012,115000,646000,761000
4,residential,10912,1958,1062000,122000,1184000
4,residential,10149,1967,1056000,516000,1572000
4,residential,11514,1958,974000,72100,1046100
4,residential,6490,1980,933000,162000,1095000
4,residential,8697,1955,1084000,25300,1109300
4,residential,8705,2010,982000,377000,1359000
4,residential,7668,1960,940000,95500,1035500
4,residential,5759,1967,827000,111000,938000
4,residential,5974,2003,905000,533000,1438000
4,townhouse,1284,2015,850000,0,850000
4,residential,7818,1968,946000,132000,1078000
4,residential,7130,1962,963000,139000,1102000
5,residential,7200,,94000,0,94000
5,school,13.68 acres,1973,4216000,17920000,22136000
5,residential,8708,1958,2109000,20800,2129800
5,residential,8710,1950,1315000,5800,1320800
5,residential,9595,1950,913000,17700,930700
5,townhouse,1179,1976,558000,108000,666000
5,residential,7818,1938,967000,36900,1003900
5,townhouse,1179,1988,488400,0,488400
5,residential,8712,1940,1777000,6600,1783600
5,residential,8715,1969,1004000,164000,1168000
5,residential,8714,1955,1004000,84100,1088100
5,residential,8709,1937,1004000,49100,1053100
5,residential,8713,2018,1004000,886000,1890000
5,residential,8712,1903,904000,305000,1209000
5,residential,8703,1977,139400,16300,155700
5,residential,9235,1949,1076000,20100,1096100
5,residential,8753,1967,1006000,117000,1123000
5,residential,7194,2016,1034000,983000,2017000
5,retail store,8712,1958,1742000,67700,1809700
5,residential,8705,1967,934000,112000,1046000
5,retail store,8712,1969,1742000,148000,1890000
5,residential,8709,1910,924000,73600,997600
5,residential,8705,1959,1004000,73500,1077500
5,townhouse,897,1969,364000,0,364000
5,residential,8705,1946,924000,27900,951900
5,residential,4355,,729000,0,729000
5,residential,8712,1948,1004000,153000,1157000
5,residential,4361,1930,792000,78300,870300
5,residential,8736,1934,1237000,12600,1249600
5,residential,8683,1939,1003000,166000,1169000
5,residential,8694,1928,1004000,360600,1364600
5,residential,8704,1946,1004000,105000,1109000
5,residential,5938,1910,879000,16200,895200
5,residential,8576,1959,2487000,10000,2497000
5,residential,8631,1941,1761000,13300,1774300
5,residential,8677,1920,2212000,43600,2255600
5,residential,8727,1910,1005000,51300,1056300
5,residential,8707,1960,1004000,52300,1056300
5,residential,6815,1910,92300,87100,179400
5,residential,8708,2000,954000,337000,1291000
5,residential,10925,1989,1085000,328000,1413000
5,residential,8716,1930,2527000,5700,2532700
5,residential,8705,1955,1953000,5700,1958700
5,residential,8707,1964,2220000,12200,2232200
5,residential,5448,1969,855000,125000,980000
5,residential,6411,1989,768000,228000,996000
5,residential,6063,1984,974000,203000,1177000
5,residential,8328,1980,989000,174000,1163000
5,residential,9325,1981,771000,182000,953000
5,residential,8226,1957,102900,106000,208900
6,residential,8708,,2002000,0,2002000
6,residential,2023,1996,607000,175000,782000
6,residential,8709,,696000,0,696000
6,residential,4323,,561000,0,561000
6,townhouse,1521,2019,931000,0,931000
6,residential,8708,1910,1776000,13600,1789600
6,retail store,8712,1910,1776000,284000,2060000
6,residential,8698,1947,903000,41300,944300
6,residential,8699,1910,903000,50100,953100
6,church,0.6 acres,1901,1308000,167300,1475300
6,residential,8712,1947,1742000,10000,1752000
6,unclassified,8.964acres,,14944000,17115700,32059700
6,retail store,7524,1945,1279000,3100,1282100
6,retail store,2673,1974,454000,387000,841000
6,residential,4360,1943,889000,8200,897200
6,residential,5808,1925,987000,370000,1357000
6,residential,4356,1955,871000,382000,1253000
6,residential,26136,1994,702000,1526000,2228000
6,,1941,,310000,0,310000
6,retail store,4356,1947,870000,120700,990700
6,retail store,8712,1971,1742000,17100,1759100
6,retail store,8712,1955,1742000,384000,2126000
6,townhouse,805,2018,498000,0,498000
6,townhouse,605,2018,477800,0,477800
6,retail store,8712,1960,2265000,4800,2269800
6,retail store,13068,1987,3397000,2700,3399700
6,storage,8712,1979,2265000,755000,3020000
6,residential,8696,1949,2260000,10000,2270000
6,retail store,12936,1981,33636000,20500,33656500
6,retail store,13068,1984,3397000,1589000,4986000
6,,4356,,496000,0,496000
6,town house,1156,2006,687000,0,687000
6,town house,1261,2006,772000,0,772000
6,town house,1248,2012,775000,0,775000
6,town house,1393,2013,1016000,0,1016000
6,storage,8712,1988,2700000,6400,2706400
6,residential,8705,1958,2785000,10000,2795000
6,retail store,17424,1994,5575000,21600,5596600
6,,20452,,6544000,0,6544000
6,,9712,,2787000,0,2787000
6,,26136,,8363000,0,8363000
6,storage,8712,1988,2787000,7300,2794300
6,retail store,8712,1965,2787000,4900,2791900
6,residential,2023,1996,607000,175000,782000
6,residential,2389,1995,583000,173000,756000
6,residential,8711,1976,1777000,21200,1798200
6,retail store,6600,1920,1121000,56800,1177800
6,town house,625,2018,388000,0,388000
6,town house,936,2012,634000,0,634000
6,storage,8712,1990,2700000,6400,2706400
7,,23210,,696300,0,696300
7,,55756,,16726000,0,16726000
7,storage,28700,1980,6428000,21300,6449300
7,storage,8712,1978,2613000,7800,2620800
7,,21284,,6385000,0,6385000
7,storage,2063,1979,597700,0,597700
7,storage,28700,1980,6428000,21300,6449300
7,storage,16379,1986,4585000,10900,4595900
7,storage,10893,1971,3267000,190000,3457000
7,storage,10890,1987,3267000,638000,3905000
7,storage,10890,1990,3267000,10500,3277500
7,storage,10896,1973,3268000,6000,3274000
7,storage,8712,1989,2612000,7400,2619400
7,storage,8712,1977,2613000,5500,2618500
7,storage,8719,2004,2615000,61000,2676000
7,,1270,,139000,0,139000
7,,2174,,239000,0,239000
7,storage,8712,1978,2613000,636000,3249000
7,storage,8712,1975,2613000,10100,2623100
7,storage,8712,2004,2613000,1887000,4500000
7,storage,8712,1968,2613000,2100,2615100
7,storage,8712,1993,2613000,6000,2619000
7,storage,8712,1975,2613000,636000,3249000
7,,2316,,141000,0,141000
7,,19578,,643000,0,643000
7,,1501,,165000,0,165000
7,unclassified,32.763 acres,,50927000,3425200,54352200
7,unclassified,8712,1970,1010000,35700,1045700
7,unclassified,20243,1905,1268000,79500,1347500
7,retail store,504,1986,78900,144000,222900
7,storage,8712,1873,1010000,1055000,2065000
7,storage,8712,1975,1010000,1481000,2491000
7,storage,43037,1979,2955000,1960000,4915000
7,storage,2000,1976,627000,24000,651000
7,,3.63 acres,,7078000,0,7078000
7,retail store,23789,2007,2690000,2296000,4986000
7,retail store,500,2013,78300,192000,270300
7,storage,3640,1976,1028400,0,1028400
7,retail store,8712,1981,1010000,159000,1169000
7,,527,,27800,0,27800
7,,832,,43900,0,43900
7,,2553,,280000,0,280000
7,,12120,,1112000,4200,1116200
7,storage,17424,1976,5227000,8100,5235100
7,,796,,87500,0,87500
7,,1840,,202000,0,202000
7,,2174,,239000,0,239000
7,,2174,,239000,0,239000
7,residential,9490,1997,2847000,22100,2869100
7,storage,8712,1977,2613000,7200,2620200
8,storage,58722,1961,18203000,35700,18238700
8,,21308,,2770000,0,2770000
8,town house,833,2007,476000,0,476000
8,residential,9980,1959,904000,13600,917600
8,residential,9701,1956,895000,59600,954600
8,residential,9096,1955,1507000,12100,1519100
8,residential,7028,1955,801000,196000,997000
8,residential,9190,1958,791000,83500,874500
8,retail store,1788 Acres,2005,25702000,88200,25790200
8,residential,9118,1993,675000,254000,929000
8,residential,7325,1955,1587000,14800,1601800
8,town house,425,2007,265100,0,265100
8,retail store,18326,1969,421400,6000,427400
8,,10691,,3100000,0,3100000
8,residential,52313,,14006000,4334000,18340000
8,residential,174247,1977,4443000,1894000,6337000
8,,9900,,631000,0,631000
8,town house,1253,1996,681000,0,681000
8,school,14.66 Acres,2016,5166000,11206000,16372000
8,townhouse,594,1998,358600,0,358600
8,retail store,1.03 Acres ,2013,11660000,97300,11757300
8,unclassified ,35980,,10092000,4500000,14592000
8,residential,8002,1958,2040000,7900,2047900
8,townhouse,1165,1977,620000,0,620000
8,residential,5995,1977,720000,103000,823000
8,residential,5995,1977,720000,134000,854000
8,retail store,48418,2008,12588000,50000,12638000
8,residential,6627,1974,864000,157000,1021000
8,residential,6439,1991,856000,264000,1120000
8,residential,6975,1974,879000,17000,896000
8,residential,7172,1974,887000,131000,1018000
8,residential,6133,1968,841000,114000,955000
8,residential,7817,1958,914000,205000,1119000
8,residential,7184,1974,888000,117000,1005000
8,residential,7222,1958,890000,45200,935200
8,residential,7805,1968,872000,122000,994000
8,residential,7805,1958,87200,165000,252200
8,residential,7924,1956,793000,74100,867100
8,townhouse,1061,1973,630200,0,630200
8,residential,7325,1955,1587000,14800,1601800
8,townhouse,1112,2007,814000,0,814000
8,residential,9142,1959,877000,80300,957300
8,townhouse,1320,2011,800000,0,800000
8,residential,8430,1974,742000,172000,914000
8,residential,15349,1963,1122000,232000,1354000
8,residential,7799,1973,1047000,14800,1061800
8,residential,7871,1967,1050000,14900,1064900
8,residential,7489,1969,985000,12800,997800
8,residential,10072,1969,907000,193000,1100000
8,residential,8396,1964,852000,129000,981000
9,residential,9129,1956,877000,51700,928700
9,residential,9370,1955,1553000,18400,1571400
9,,26910,,7480000,0,7480000
9,storage,25087,1978,7274000,17200,7291200
9,unclassified,3.36 Acres,,43858000,2387000,46245000
9,townhouse,1468,2005,1075000,0,1075000
9,townhouse,863,2005,590000,0,590000
9,townhouse,934,2009,564000,0,564000
9,townhouse,949,2005,632000,0,632000
9,townhouse,878,2005,527000,0,527000
9,townhouse,938,2012,605000,0,605000
9,townhouse,926,2008,584000,0,584000
9,townhouse,650,2008,419000,0,419000
9,townhouse,982,2008,648000,0,648000
9,townhouse,821,2008,529000,0,529000
9,townhouse,911,2008,607000,0,607000
9,townhouse,1073,2008,687000,0,687000
9,townhouse,994,2008,657000,0,657000
9,townhouse,826,2005,502000,0,502000
9,residential,9093,1954,1507000,18500,1525500
9,residential,9007,1958,872000,39000,911000
9,residential,9093,1955,788000,65700,853700
9,residential,9124,1968,745000,111000,856000
9,townhouse,1292,1979,573200,0,573200
9,townhouse,1291,1979,596200,0,596200
9,residential,7423,1986,1688000,13300,1701300
9,residential,9705,1958,896000,88500,984500
9,townhouse,1249,2004,705000,0,705000
9,townhouse,932,1996,471000,0,471000
9,townhouse,1440,1998,870000,0,870000
9,townhouse,860,1998,456000,0,456000
9,retail store,32060,2001,3853000,19659000,23512000
9,unclassified,11.91 Acres,1973,32685000,15411000,48096000
9,unclassified,2.107 Acres,1974,8662000,193000,8855000
9,residential,6489,1983,960000,104000,1064000
9,residential,5997,2017,933000,380000,1313000
9,residential,5795,1974,881000,127000,1008000
9,residential,21308,1932,1222000,168000,1390000
9,residential,4064,1989,742000,161000,903000
9,residential,4103,1977,745000,134000,879000
9,residential,6946,1945,848000,25700,873700
9,unclassified,8184,1966,895000,315000,1210000
9,residential,3120,1977,78000,70300,148300
9,residential,3909,1970,732000,85700,817700
9,residential,3961,1970,735000,62300,797300
9,residential,4064,1950,705000,119000,824000
9,residential,8316,1061,950000,210000,1160000
9,residential,9664,1978,880000,127000,1007000
9,residential,17682,1955,1146000,200000,1346000
9,townhouse,846,1995,458000,0,458000
10,townhouse,932,1978,508400,0,508400
10,townhouse,377,1979,600000,0,600000
10,townhouse,549,1979,647000,0,647000
10,townhouse,1315,2008,711000,0,711000
10,residential,6728,1978,890000,117000,1007000
10,residential,4648,1978,759000,126000,885000
10,residential,4346,1978,766000,97300,863300
10,residential,4053,1978,746000,95000,841000
10,residential,4021,1978,744000,106000,850000
10,residential,4093,1978,749000,87500,836500
10,residential,4008,1978,743000,109000,852000
10,residential,4062,1978,747000,109000,856000
10,residential,4000,1978,743000,110000,853000
10,townhouse,1597,1990,841000,0,841000
10,townhouse,1597,1990,869000,0,869000
10,townhouse,1042,1977,517800,0,517800
10,townhouse,1037,1977,535700,0,535700
10,townhouse,1037,1977,515700,0,817700
10,residential,6865,1987,924000,234000,1158000
10,residential,6026,1985,883000,158000,1041000
10,residential,6026,1985,883000,302000,1185000
10,residential,6028,1986,856000,382000,1238000
10,residential,8709,1986,890000,190000,1080000
10,residential,9680,1987,987000,168000,1155000
10,residential,6050,1985,884000,166000,1050000
10,residential,7087,1988,934000,320000,1254000
10,residential,10046,1986,999000,221000,1220000
10,residential,6131,1988,934000,256000,1190000
10,residential,4033,1985,785000,119000,904000
10,residential,5875,1985,893000,239000,1132000
10,residential,4101,1985,774000,153000,927000
10,school,5.4 Acres,1988,2348000,4880000,7228000
10,residential,5994,1980,899000,245000,1144000
10,residential,8307,1980,1037000,161000,1198000
10,residential,6071,1980,903000,233000,1136000
10,residential,6162,1980,908000,178000,1086000
10,residential,6016,1980,900000,192000,1092000
10,residential,7003,1980,977000,238000,1215000
10,residential,6084,1981,904000,178000,1082000
10,residential,6103,1980,905000,239000,1144000
10,residential,10734,1981,1133000,281000,1414000
10,residential,8424,1985,1012000,225000,1237000
10,residential,6073,1981,903000,345000,1248000
10,residential,6034,1982,901000,213000,1114000
10,residential,6022,1981,901000,273000,1174000
10,residential,6125,1980,906000,136000,1042000
10,residential,6240,1980,913000,258000,1171000
10,residential,7942,1980,991000,207000,1198000
10,residential,6043,1980,902000,192000,1094000
10,residential,6703,1980,935000,167000,1102000
11,residential,10477,1976,1267000,212000,1479000
11,residential,6631,1976,1082000,150000,1232000
11,residential,7031,1980,1005000,220000,1225000
11,residential,7697,1974,1138000,186000,1324000
11,residential,6023,1980,1046000,154000,1200000
11,residential,6300,1994,1062000,449000,1511000
11,residential,5094,1993,2079000,254000,2333000
11,residential,10472,1965,2824000,65100,2889100
11,residential,8150,2001,2707000,1370000,4077000
11,residential,8560,1968,1181000,136000,1317000
11,residential,10544,1967,1217000,148000,1365000
11,residential,9166,1973,1100000,211000,1311000
11,residential,11790,1972,1050000,96700,1146700
11,residential,0.968 acres,1968,1389000,426000,1815000
11,residential,17976,2014,991000,793000,1784000
11,residential,1.077 Acres,1954,1153000,36200,1189200
11,residential,4483,1989,769000,196000,965000
11,residential,8287,1976,949000,151000,1100000
11,residential,12122,1955,1082000,76500,1158500
11,residential,5171,1981,903000,286000,1189000
11,residential,5156,1996,806000,410000,1216000
11,residential,10433,1925,1032000,69400,1101400
11,,4854,,197000,0,197000
11,townhouse,1100,,675800,0,675800
11,townhouse,1172,,703100,0,703100
11,residential,4633,1977,778000,128000,906000
11,residential,5205,1977,809000,126000,935000
11,residential,4486,1979,769000,112000,1544476
11,residential,4004,1980,737000,178000,915000
11,residential,4789,1980,786000,163000,949000
11,residential,7893,1986,933000,209000,1142000
11,residential,5707,1925,776000,87900,863900
11,residential,13854,1982,1099000,170000,1269000
11,residential,5974,2005,949000,655000,1604000
11,residential,19908,1968,1091000,101000,1192000
11,residential,7577,2004,1030000,729000,1759000
11,residential,3627,1976,716000,111000,827000
11,residential,4052,1979,714000,135000,849000
11,residential,7231,1991,1137000,13800,1150800
11,residential,3630,2011,716000,375000,1091000
11,residential,2740,1990,651000,245000,896000
11,residential,3626,1983,716000,200000,916000
11,residential,5155,1991,806000,230000,1036000
11,residential,8413,1965,213000,71200,284200
11,residential,9785,1975,2721000,230000,2951000
11,residential,6119,1987,854000,203000,1057000
11,residential,3560,1979,711000,153000,864000
11,residential,6016,1980,849000,135000,984000
11,residential,4510,1977,771000,87900,858900
11,residential,5029,1980,798000,120000,918000
12,townhouse,2004,1991,944000,0,944000
12,townhouse,2151,1991,1161000,0,1161000
12,residential,16795,1995,1166000,433000,1599000
12,residential,7668,1992,947000,451000,1398000
12,residential,7441,1992,937000,348000,1285000
12,residential,9628,1992,1024000,289000,1313000
12,residential,5986,1991,868000,286000,1154000
12,residential,4475,1999,906000,390000,1296000
12,residential,5959,1999,997000,413000,1410000
12,residential,4730,2000,922000,467000,1389000
12,residential,6900,1999,1068000,442000,1510000
12,residential,7625,1999,1106000,584000,1690000
12,residential,5960,1999,997000,469000,1466000
12,residential,5970,1999,1015000,453000,1468000
12,townhouse,1556,2000,850000,0,850000
12,residential,7423,1996,1077000,491000,1568000
12,residential,5969,1995,1015000,423000,1438000
12,residential,6805,1995,1045000,423000,1468000
12,residential,6997,1997,1054000,368000,1422000
12,residential,7578,1997,1085000,500000,1585000
12,townhouse,1099,1994,563000,0,563000
12,residential,6059,1991,872000,346000,1218000
12,residential,7084,1992,921000,340000,1261000
12,residential,5990,1991,886000,33800,919800
12,residential,6799,1992,908000,271000,1179000
12,residential,5016,1991,817000,374000,1191000
12,townhouse,1406,1993,726000,0,726000
12,residential,6624,1990,900000,310000,1210000
12,residential,6021,1992,870000,380000,1250000
12,residential,5163,1988,826000,245000,1071000
12,residential,7658,1987,946000,355000,1301000
12,residential,4873,1987,810000,322000,1132000
12,residential,5690,1987,854000,286000,1140000
12,residential,6687,1987,921000,352000,1273000
12,school,6.05 Acres ,1993,2516000,4876000,7392000
12,residential,10324,1991,1049000,482000,1531000
12,residential,7997,1989,960000,283000,1243000
12,residential,6738,1992,905000,363000,1268000
12,residential,7894,1989,956000,451000,1407000
12,residential,7784,1989,951000,322000,1273000
12,residential,6642,1991,892000,289000,1181000
12,residential,9266,1990,1031000,339000,1370000
12,residential,10109,1989,1041000,255000,1296000
12,residential,6561,1985,897000,319000,1216000
12,residential,5541,1985,847000,188000,1035000
12,residential,6605,1985,917000,174000,1091000
12,residential,13009,1985,1124000,275000,1399000
12,residential,16706,1989,1263000,572000,1835000
12,residential,6783,1989,907000,301000,1208000
12,residential,9201,1988,1008000,398000,1406000
13,residential,20774,2017,1696000,1086000,2782000
13,residential,12486,2017,1492000,884000,2376000
13,residential,6319,2007,1103000,486000,1589000
13,residential,7449,2007,1167000,376000,1543000
13,residential,4962,2007,1014000,339000,1353000
13,residential,4166,2006,927000,320000,1247000
13,residential,12271,2010,1456000,768000,2224000
13,residential,4844,2008,976000,335000,1311000
13,residential,4607,2006,990000,333000,1323000
13,residential,9699,2006,1278000,465000,1743000
13,residential,6609,2006,1143000,429000,1572000
13,residential,6835,2005,1133000,426000,1559000
13,residential,6135,2005,1091000,440000,1531000
13,townhouse,1377,2006,786000,0,786000
13,townhouse,1542,2005,967000,0,967000
13,residential,4360,2005,972000,282000,1254000
13,residential,4069,2005,947000,296000,1243000
13,residential,4058,2005,946000,317000,1263000
13,residential,4230,2005,961000,305000,1266000
13,residential,4058,2005,946000,279000,1225000
13,residential,4801,2005,1004000,351000,1355000
13,residential,4456,2005,979000,369000,1348000
13,residential,4209,2005,959000,335000,1294000
13,residential,2150,2005,687000,265000,952000
13,residential,6308,2004,1102000,486000,1588000
13,residential,6093,2004,1089000,483000,1572000
13,residential,4316,2002,968000,306000,1274000
13,residential,12099,2003,1448000,731000,2179000
13,residential,10412,2002,1441000,735000,2176000
13,residential,8971,2003,1306000,471000,1777000
13,residential,6350,2003,1127000,459000,1586000
13,residential,5974,2004,1079000,423000,1502000
13,residential,6135,2003,1091000,214000,1305000
13,residential,6846,2003,1134000,332000,1466000
13,residential,5909,2003,1077000,326000,1403000
13,residential,5974,2004,10081000,414000,10495000
13,residential,6566,2004,1084000,489000,1573000
13,residential,6337,2001,1104000,411000,1515000
13,residential,4295,1997,967000,338000,1305000
13,residential,5997,1997,1082000,342000,1424000
13,residential,5295,1996,1038000,388000,1426000
13,residential,7019,1999,1143000,399000,1542000
13,residential,6295,2000,1102000,381000,1483000
13,residential,6226,2000,1020000,376000,1396000
13,residential,5153,1991,1028000,322000,1350000
13,residential,6058,1995,1086000,417000,1503000
13,residential,8909,1995,1241000,369000,1610000
13,residential,5997,1997,1082000,342000,1424000
13,residential,6531,1996,1138000,364000,1502000
13,residential,5970,2000,1048000,422000,1470000
14,residential,10 Acres,1961,4381000,2883000,7264000
14,residential,9884,1957,1050000,79300,1129300
14,residential,10882,2012,1282000,1305000,2587000
14,residential,6005,1998,2364000,286000,2650000
14,residential,6023,1998,2280000,784000,3064000
14,residential,9914,1972,1241000,169000,1410000
14,residential,5359,1952,2383000,175000,2558000
14,residential,4128,1937,1163000,536000,1699000
14,residential,4926,1988,2318000,421000,2739000
14,residential,3711,1976,2312000,292000,2604000
14,residential,5885,1981,3011000,1327000,4338000
14,residential,3900,1942,2184000,124000,2308000
14,residential,5683,1965,2410000,247000,2657000
14,residential,5434,1984,2272000,387000,2659000
14,residential,4812,1992,2311000,692000,3003000
14,residential,3659,1942,219000,178000,397000
14,residential,4233,1964,2206000,141000,2347000
14,residential,4183,1992,2615000,540000,3155000
14,residential,6334,2018,231600,464000,695600
14,residential,7500,2003,1220000,644000,1864000
14,residential,5316,1955,1043000,52200,1095200
14,residential,7494,2016,1219000,1049000,2268000
14,unclassified,7494,1962,1219000,149000,1368000
14,residential,7494,2016,1219000,1068000,2287000
14,residential,7381,1969,1122000,106000,1228000
14,residential,6020,1996,934000,443000,1377000
14,residential,7384,1960,1122000,298000,1420000
14,residential,9174,1959,1209000,54400,1263400
14,residential,10082,2009,1282000,997000,2279000
14,residential,9945,1975,1231000,143000,1374000
14,residential,11212,1980,1760000,14900,1774900
14,residential,12917,2006,1496000,1100000,2596000
14,residential,9889,1982,1240000,201000,1441000
14,residential,7194,1977,1176000,347000,1523000
14,residential,9825,1979,1239000,176000,1415000
14,residential,10016,1977,1318000,298000,1616000
14,residential,7194,1976,1086000,112000,1198000
14,residential,7906,1976,1121000,233000,1354000
14,residential,7554,1976,1058000,167000,1225000
14,residential,8064,1979,1054000,210000,1264000
14,residential,7368,1979,912000,212000,1124000
14,residential,8934,1978,1004000,249000,1253000
14,residential,7206,1989,869000,313000,1182000
14,residential,11900,1976,1076000,223000,1299000
14,residential,6525,1976,875000,106000,981000
14,residential,7924,1976,941000,130000,1071000
14,residential,7654,1975,1053000,149000,1202000
14,residential,8973,2016,1171000,845000,2016000
14,residential,9258,1976,987000,143000,1130000
14,residential,6595,1976,1142000,223000,1365000